BEAUTY'S	B Y UW T IY Z
RIPER	R AY P ER
FEED'ST	F IY D S T
SELF-SUBSTANTIAL	S EH L F S AH B S T AE N SH AH L
BURIEST	B EH R IY AH S T
CHURL	CH AH R L
MAK'ST	M AE K S T
NIGGARDING	N IH G AA R D AH NG
GLUTTON	G L AH T AH N
DAYS;	D EY Z
ALL-EATING	AO L IY T IH NG
THRIFTLESS	TH R IH F T L AH S
COULDST	K OW AH L D S T
'THIS	TH IH Z
EXCUSE'	IH K S K Y UW S
EXCUSE'(2)	IH K S K Y UW Z
FEEL'ST	F IY L S T
VIEWEST	V Y UW AH S T
RENEWEST	R IY N UW AH S T
UNBLESS	AH N B L EH S
UNEARED	AH N IH ER D
TILLAGE	T IH L AE JH
SELF-LOVE	S EH L F L AH V
UNTHRIFTY	AH N TH R IH F T IY
LOVELINESS	L AH V L IY N AH S
BEAUTEOUS	B Y UW T IY AH S
BOUNTEOUS	B AW N T IY AH S
PROFITLESS	P R AA F AH T L AH S
USURER	Y UW ZH ER ER
CANST	K AE N S T
TOMBED	T UW M D
TH'	T IY EY CH
NEVER-RESTING	N EH V ER R EH S T IH NG
O'ER-SNOWED	OW ER S N OW D
BARENESS	B EH R N AH S
VIAL;	V AY AH L
SELF-KILLED	S EH L F K IH L D
HAPPIES	HH AE P IY Z
LOAN;	L OW N
REFIGURED	R IY F IH G Y ER D
SHOULDST	SH OW L D S T
SELF-WILLED	S EH L F W IH L D
NEW-APPEARING	N UW AH P IH R IH NG
STEEP-UP	S T IY P AH P
HIGHMOST	HH AY M OW S T
REELETH	R IY L IH TH
DUTEOUS	D Y UW T IY AH S
OUT-GOING	AW T G OW IH NG
UNLOOKED	AH N L UH K T
DIEST	D AY AH S T
HEAR'ST	HH IY R S T
LOV'ST	L AA V S T
RECEIV'ST	R AH S IY V S T
WELL-TUNED	W EH L T UW N D
SINGLENESS	S IH NG G AH L N AH S
ORDERING;	AO R D ER IH NG
'THOU	TH UW
NONE'	N AH N
CONSUM'ST	K AA N S AH M S T
MAKELESS	M EY K L AH S
UNTHRIFT	AH N TH R IH F T
IT;	IH T
MURD'ROUS	M AH R D R AH S
BEAR'ST	B AH AA R S T
UNPROVIDENT	AH N P R AH V AY D AH N T
'GAINST	G EY N S T
STICK'ST	S T IH K S T
RUINATE	R UW AH N AH T
KIND-HEARTED	K AY N D HH AA R T AH D
GROW'ST	G R OW S T
DEPARTEST	D IY P AA R T AH S T
YOUNGLY	Y AH NG L IY
BESTOW'ST	B IH S T OW S T
MAYST	M EY S T
CONVERTEST	K AH N V ER T AH S T
THREESCORE	TH R IY S K OW R
BARRENLY	B AE R AH N L IY
MORE;	M OW R
SILVERED	S IH L V ER D
O'ER	OW ER
ERST	AH R S T
GIRDED	G ER D IH D
BRISTLY	B R IH S AH L IY
HONOUR	AA N ER
UNTHRIFTS	AH N TH R IH F T S
METHINKS	M EH TH AH NG K S
DEARTHS	D ER TH S
SEASONS'	S IY Z AH N Z
TELL;	T EH L
WOULDST	W OW L D S T
TRUTH'S	T R UW TH S
PRESENTETH	P R EH Z AH N T IH TH
NOUGHT	N AO T
WHEREON	W EH ER AO N
SELF-SAME	S EH L F S EY M
VAUNT	V AO N T
INCONSTANT	IH N K AA N S T AH N T
DEBATETH	D AH B EY T IH TH
ENGRAFT	EH N G R AE F T
WHEREFORE	W EH ER F OW R
LIKER	L AY K ER
YELLOWED	Y EH L OW D
METRE	M IY T ER
UNTRIMMED	AH N T R IH M D
OW'ST	OW S T
WAND'REST	W AA N D R AH S T
LONG-LIVED	L AO NG L IH V D
FLEET'ST	F L IY T S T
WHATE'ER	W AA T AH AH R
SWIFT-FOOTED	S W IH F T F UH T IH D
GAZETH	G EY Z IH TH
AMAZETH	AH M EY Z IH TH
A-DOTING	EY D OW T IH NG
COUPLEMENT	K AH P AH L M AH N T
FIRST-BORN	F ER S T B AO R N
RONDURE	R AA N D Y AH R
FURROWS	F ER OW Z
SEEMLY	S IY M L IY
RAIMENT	R EY M AH N T
THYSELF	DH AY S EH L F
GAV'ST	G AE V S T
UNPERFECT	AH N P ER F AH K T
STRENGTH'S	S T R EH NG K TH S
HEART;	HH AA R T
O'ERCHARGED	AH AH R CH AH R JH D
BURTHEN	B AH R TH AH N
PRESAGERS	P R EH S IH JH ER Z
STELLED	S T EH L D
BOSOM'S	B UH Z AH M Z
WHERE-THROUGH	W EH R TH R UW
THEE;	DH IY
FAVOUR	F EY V ER
MOST;	M OW S T
PRINCES'	P R IH N S AH Z
PRINCES'(2)	P R IH N S IH Z
FAVOURITES	F AE V AH R AY T S
FAMOUSED	F EY M AH S T
VASSALAGE	V AE S AH L IH JH
KNIT;	N IH T
EMBASSAGE	IH M B EY S IH JH
SOUL'S	S OW L Z
RESPOSE	R EY Z P OW Z
SIGHTLESS	S AY T L AH S
DEBARRED	D IY B AA R D
EITHER'S	IY DH ER Z
SWART-COMPLEXIONED	S W AO R T K AH M P L EH K SH AH N D
TWIRE	T W AY R
GILD'ST	JH IH L D S T
GRIEF'S	G R IY F S
BEWEEP	B IH W IY P
BOOTLESS	B UW T L AH S
HAPLY	HH AE P L IY
DATELESS	D EY T L AH S
FORE-BEMOANED	F AO R B IH M OW N D
STOL'N	S T AA L N
WELL-CONTENTED	W EH L K AH N T EH N T AH D
RE-SURVEY	R EY S ER V EY
BETT'RING	B EH T R AH NG
VOUCHSAFE	V AW CH S EY F
'HAD	HH AE D
EQUIPAGE	IH K W IH P IH JH
LOVE'	L AH V
GREEN;	G R IY N
ANON	AE N AH N
BASEST	B EY S AH S T
SPLENDOUR	S P L EH N D AH R
ALACK	AH L AE K
DISDAINETH	D IH S D EY N IH TH
STAINETH	S T EY N IH TH
DIDST	D IH D S T
O'ERTAKE	AA AH R T EY K
BRAV'RY	B R AE V R IY
STORM-BEATEN	S T AO R M B IY T AH N
PHYSIC	F AY Z AH K
OFFENDER'S	AH F EH N D ER Z
OFFENCE'S	AH F EH N S IH Z
SALVING	S AA V IH NG
ACCESSARY	AE K S EH S EH R IY
SOURLY	S AW ER L IY
SEPARABLE	S EH P ER AH B AH L
BEWAILED	B IH W EY L D
ENGRAFTED	EH N G R AE F T IH D
POUR'ST	P AH R S T
AUGHT	AO T
RHYMERS	R AY M ER Z
INVOCATE	IH N V OW K AH T
IS'T	IH S T
DESERV'ST	D AH S AH R V S T
TEACHEST	T IY CH AH S T
HADST	HH AE D S T
RECEIVEST	R IH S IY V AH S T
USEST	Y UW S AH S T
DECEIVEST	D IH S IY V AH S T
WILFUL	W IH L F AH L
REFUSEST	R IH F Y UW Z AH S T
HATE'S	HH EY TS
SPITES	S P AY T S
MIGHTST	M AY T S T
FORBEAR	F AO R B AE ER
KNOW'ST	N OW S T
SUFF'RING	S AH F R AH NG
UNRESPECTED	AH N R IH S P EH K T IH D
SHADOW'S	SH AE D OW Z
UNSEEING	AH N S IY IH NG
PRESENT-ABSENT	P R EH Z AH N T AE B S AH N T
RECURED	R IY S Y ER D
IMPANELLED	IH M P AE N AH L D
MOIETY	M OW AY AH T IY
FAMISHED	F AE M IH SH T
SMOTHER;	S M AH DH ER
AWAKES	AH W EY K S
THIEVISH	TH IY V IH SH
GRAVITY;	G R AE V AH T IY
UPREAR	AH P R IH ER
TRAVEL'S	T R AE V AH L Z
'THUS	TH AH Z
FRIEND'	F R EH N D
PLODS	P L AA D Z
DULLY	D AH L IY
WRETCH	R EH CH
OFFENCE	AH F EH N S
PERFECT'ST	P AH R F EH K T S T
NEIGH	N EY
WILFUL-SLOW	W IH L F AH L S L OW
UP-LOCKED	AH P L AA K T
CARCANET	K AA R K AH N AH T
SPECIAL-BLEST	S P EH SH AH L B L EH S T
WHEREOF	W EH ER AH V
FOISON	F OW IY Z AO N
ODOUR	OW D ER
UNWOOED	AH N W UW D
ODOURS	OW D ER S
UNSWEPT	AH N S W EH P T
BESMEARED	B IH S M IH ER D
SLUTTISH	S L AH T AH SH
BROILS	B R OY L Z
ALL-OBLIVIOUS	AO L AH B L IH V IY AH S
TO-DAY	T UW D EY
TO-MORROW	T UW M AA R OW
FULNESS	F UH L N AH S
DULNESS	D AH L N AH S
SPEND;	S P EH N D
WORLD-WITHOUT-END	W ER L D W IH TH AW T EH N D
SUFFERANCE	S AH F ER AH N S
PRIVILAGE	P R AY V AH L AH JH
SELF-DOING	S EH L F D UW IH NG
LABOURING	L EY B ER IH NG
PEBBLED	P EH B AH L D
WHEREWITH	W EH ER W IH TH
SLUMBERS	S L AH M B ER Z
SEND'ST	S EH N D S T
POSSESSETH	P AH Z EH S IH TH
PART;	P AA R T
BEATED	B IY T IH D
CHOPT	CH AA P T
SELF-LOVING	S EH L F L AH V IH NG
O'ERWORN	AH AH R W AH R N
STEEPY	S T IY P IY
RICH-PROUD	R IH CH P R AW D
OUTWORN	AW T W OW R N
DOWN-RASED	D AW N R EY Z D
O'ERSWAYS	OW ER Z W EY Z
WRACKFUL	R AE K F AH L
BATT'RING	B AE T R AH NG
JOLLITY	JH AA L AH T IY
SHAMEFULLY	SH EY M F AH L IY
STRUMPETED	S T R AH M P EH T IH D
TONGUE-TIED	T AH NG T AY D
DOCTOR-LIKE	D AA K T ER L AY K
MISCALLED	M IH S K AO L D
IMPIETY	IH M P AY AH T IY
BEGGARED	B EH G ER D
SEPULCHRES	S EH P AH L K ER Z
CHURLS	CH AH R L Z
MATCHETH	M AE CH IH TH
SLANDER'S	S L AE N D ER Z
PRESENT'ST	P R IY S EH N T S T
VILEST	V IH L AH S T
REHEARSE;	R IH HH ER S
SEEST	S IY AH S T
FADETH	F EY D IH TH
DEATH-BED	D EH TH B EH D
PERCEIV'ST	P AH R S IY V S T
REVIEWEST	R IY V Y UW AH S T
WRETCH'S	R EH CH IX Z
SWEET-SEASONED	S W IY T S IY Z AH N D
GROUND;	G R AW N D
'TWIXT	T W IH K S T
ENJOYER	EH N JH OY ER
FILCHING	F IH L CH IH NG
GLUTTONING	G L AH T AH N IH NG
NEW-FOUND	N UW F AW N D
POESY	P OW AH Z IY
LEARNED'S	L ER N D Z
BEHAVIOUR	B IH HH EY V Y ER
SHALLOWEST	SH AE L OW AH S T
SOUNDLESS	S AW N D L AH S
O'ER-READ	OW ER R EH D
BREATHERS	B R IY DH ER Z
ATTAINT	AE T EY N T
O'ERLOOK	AH AH R L AH K
TIME-BETTERING	T AY M B EH T ER IH NG
TRUE-TELLING	T R UW T EH L IH NG
IMMURED	IH M Y AH R D
DIGNIFIES	D IH G N AH F AY Z
UNLETTERED	AH N L EH T ER D
HINDMOST	HH AY N D M OW S T
INHEARSE	IH N HH ER S
COMPEERS	K AH M P IH ER Z
SWERVING	S W ER V IH NG
ATTAINTED	AH T EY N T EH D
DOUBLE-VANTAGE	D AH B AH L V AE N T AH JH
LAMENESS	L EY M N AH S
WRONK	R AO NG K
AFTER-LOSS	AE F T ER L AO S
'SCAPED	S K EY P T
REARWARD	R IH ER W ER D
PURPOSED	P ER P AH S T
GRIEFS	G R IY F S
NEW-FANGLED	N UW F AE NG G AH L D
HUMOUR	HH Y UW M ER
GARMENTS'	G AA R M AH N T S
WRETCHCD	R EH CH D
BLESSED-FAIR	B L EH S T F EH R
MANY'S	M EH N IY Z
EVE'S	IY V Z
TIBEY	T IH B IY
OUTBRAVES	AW T B R EY V Z
SOUREST	S AW ER AH S T
DISPRAISE	D IH S P R EY Z
ILL-USED	IH L Y UW Z D
WANTONNESS	W AO N T AH N AH S
THRONED	TH R OW N D
GAZERS	G EY Z ER Z
FREEZINGS	F R IY Z IH NG Z
WOMBS	W UW M Z
LORDS'	L AO R D Z
UNFATHERED	AH N F AA DH ER D
PROUD-PIED	P R AW D P AY D
FEARFULLY	F IH ER F AH L IY
COLOUR	K AH L ER
FORGET'ST	F AO R JH AH T S T
SPEND'ST	S P EH N D S T
RESTY	R EH S T IY
PREVENT'ST	P R IY V EH N T S T
'TRUTH	T R AH TH
INTERMIXED'	IH N T ER M IH K S T
FOR'T	F AO R T
MERCHANDIZED	M AH R CH AH N D AY Z D
ESTEEMING	IH S T IY M IH NG
PHILOMEL	F IH L AH M AH L
BURTHENS	B AH R TH AH N Z
OVER-GOES	OW V ER G OW Z
SUMMERS'	S AH M ER Z
UNBRED	AH N B R EH D
WIGHTS	W AY T S
BLAZON	B L EY Z AH N
PREFIGURING	P R IY F IH G Y ER IH NG
INCERTAINTIES	IH N S ER T AH N T IY Z
TYRANTS'	T AY R AH N T S
PREPOSTEROUSLY	P R IH P AA S T AH R AH S L IY
OFFENCES	AH F EH N S IH Z
BLENCHES	B L EH N CH AH Z
DYER'S	D AY ER Z
O'ER-GREEN	OW ER G R IY N
STEELED	S T IY L D
ABYSM	AE B AH Z AH M
ADDER'S	AE D ER Z
FLATTERER	F L AE T ER ER
EFFECTUALLY	IH F EH K CH AH W AH L IY
RUD'ST	R AH D S T
DEFORMED'ST	D AH F AO R M AH D S T
MAKETH	M EY K IH TH
SAITH	S EY TH
CHERUBINS	CH AH R UW B AH N Z
'GREEING	G R IY AH NG
MILLIONED	M IH L Y AH N D
SHARP'ST	SH AA R P S T
ALT'RING	AE L T R AH NG
'NOW	N OW
BEST'	B EH S T
INCERTAINTY	IH N S ER T AH N T IY
EVER-FIXED	EH V ER F IH K S T
TEMPESTS	T EH M P AH S T S
SHAKEN;	SH EY K AH N
WAND'RING	W AA N D R IH NG
SICKLE'S	S IH K AH L Z
SCANTED	S K AE N T IH D
WHERETO	W EH R AH T OW
DEAR-PURCHASED	D IH R P ER CH AH S T
WILFULNESS	W IH L F AH L N AH S
WAKENED	W EY K AH N D
NE'ER-CLOYING	N EH R K L OY IH NG
FEEDING;	F IY D IH NG
MEETNESS	M IY T N AH S
T'	T IY
LIMBECKS	L IH M B AH K S
UNKINDNESS	AH N K AY N D N AH S
Y'HAVE	Y HH EY V
BOSOMS	B UH Z AH M Z
SALUTATION	S AE L Y AH T EY SH AH N
SPORTIVE	S P OW R T IH V
FRAILER	F R EY L ER
BEVEL;	B EH V AH L
CHARACTERED	K AE R IH K T ER D
FORGETFULNESS	F AO R G EH T F AH L N AH S
WOND'RING	W AA N D R AH NG
BUILDED	B IH L D IH D
THRALLED	TH R AO L D
SHORT-NUMBERED	SH AO R T N AH M B ER D
WERE'T	W EH R AH T
EXTERN	EH K S T ER N
HONOURING	AA N ER IH NG
SWEET;	S W IY T
SAVOUR	S AE V AH R
THRIVERS	TH R AY V ER Z
OBLATION	AA B L EY SH AH N
SUBORNED	S AH B AO R N D
SHOW'ST	SH OW S T
GOEST	G OW AH S T
QUIETUS	K W IY T AH S
FAIRING	F EH R IH NG
PROFANED	P R OW F EY N D
MISTRESS'	M IH S T R AH S
PLAY'ST	P L EY S T
SWAY'ST	S W EY S T
DAMASKED	D AE M AE S K T
TYRANNOUS	T AH R AE N AH S
CRUEL;	K R UW AH L
GROAN;	G R OW N
JUDGMENT'S	JH AH JH M AH N TS
BESEEM	B IH S IY M
BESHREW	B IH SH R UW
ME;	M IY
SWEET'ST	S W IY T S T
THREE-FOLD	TH R IY F OW L D
WHOE'ER	W OW AH AH R
RIGOUR	R IH G AH R
GAOL	G EY AH L
COVETOUS	K AH V AH T AH S
SURETY-LIKE	SH UH R AH T IY L AY K
PUT'ST	P AH T S T
'WILL'	W IH L
OVER-PLUS	OW V ER P L AH S
ADDETH	AE D IH TH
BESEECHERS	B IH S IY CH ER Z
LOVE-SUIT	L AH V S UW T
FULFIL	F UH L F AH L
OVER-PARTIAL	OW V ER P AA R SH AH L
UNTUTORED	AH N T UW T ER D
UNLEARNED	AH N L ER N D
FALSE-SPEAKING	F AO L S S P IY K IH NG
ELSEWHERE;	EH L S W EH ER
NEED'ST	N IY D S T
O'ERPRESSED	AH AH R P R AH S T
PITY-WANTING	P IH T IY W AA N T IH NG
ILL-WRESTING	IH L R EH S T IH NG
SLANDERERS	S L AE N D ER ER Z
TONGUE'S	T AH NG Z
REPROVING	R IY P R UW V IH NG
BEDS'	B EH D Z
IMPORTUNE	IH M P ER T UW N
SELF-EXAMPLE	S EH L F IH G Z AE M P AH L
HUSWIFE	HH AH S W AY F
PRIZING	P R AY Z IH NG
DISCONTENT;	D IH S K AH N T EH N T
RUN'ST	R AH N S T
WORSER	W ER S ER
TEMPTETH	T EH M P T IH TH
'I	IY
HATE'	HH EY T
'NOT	N AA T
YOU'	Y UW
INHERITORS	IH N HH EH R AH T ER Z
SERVANT'S	S ER V AH N TS
STORE;	S T OW R
DROSS;	D R AA S
NURSETH	N ER S IH TH
FRANTIC-MAD	F R AE N T IH K M AE D
CENSURES	S EH N CH ER Z
ARIGHT	AH R AY T
KEEP'ST	K IY P S T
WELL-SEEING	W EH L S IY IH NG
ALL-TYRANT	AO L T AY R AH N T
HATETH	HH EY T IH TH
FROWN'ST	F R OW N S T
LOUR'ST	L AH R S T
INSUFFICIENCY	IH N S AH F IH SH AH N S IY
WARRANTISE	W AO R AH N T AY Z
UNWORTHINESS	AH N W ER DH IY N AH S
BED-VOW	B EH D V AW
OATHS'	OW DH Z
OATHS'(2)	OW TH S
DIAN'S	D AY AH N Z
LOVE-KINDLING	L AH V K IH N D L IH NG
VALLEY-FOUNTAIN	V AE L IY F AW N T AH N
SEETING	S IY T AH NG
NEW-FIRED	N UW F AY ER D
WITHAL	W IH TH AO L
THITHER	TH IH DH ER
HIED	HH AY D
DISTEMPERED	D IH S T EH M P ER D
FIRE;	F AY ER
LOVE-GOD	L AH V G AA D
HEART-INFLAMING	HH AA R T IH N F L EY M IH NG
VOTARY	V OW T EH R IY
QUENCHED	K W EH N CH T
DISCASED	D IH S K EY S T
